50 50
0 2 4 6 8 10 12 14 12 12 12 12 12 12 12 12 12 12 12 12 12 12 12 12 12 12 12 12 12 12 12 12 12 12 12 12 12 12 12 12 12 12 12 12 12 12 12 12 12 12 
1 3 5 7 9 11 13 15 12 12 12 12 12 12 12 12 12 12 12 12 12 12 12 12 12 12 12 12 12 12 12 12 12 12 12 12 12 12 12 12 12 12 12 12 12 12 12 12 12 12 
12 12 0 0 0 0 0 0 0 0 0 0 0 0 0 0 0 0 0 0 0 10 9 9 9 9 9 9 9 9 9 9 9 9 10 14 14 14 14 14 14 14 14 14 14 14 14 14 12 12 
12 12 0 0 0 0 0 0 0 0 0 0 0 0 0 0 0 0 0 0 0 10 9 9 9 9 9 9 9 9 9 9 9 9 10 14 14 14 14 14 14 14 14 14 14 14 14 14 12 12 
12 12 0 0 0 0 0 0 0 0 0 0 0 0 0 0 0 0 0 0 0 10 9 9 9 9 9 9 9 9 9 9 9 9 10 14 14 14 14 14 14 14 14 14 14 14 14 14 12 12 
12 12 0 0 0 0 0 0 0 0 0 0 0 0 0 0 0 0 0 0 0 10 9 9 9 9 9 9 9 9 9 9 9 9 10 14 14 14 14 14 14 14 14 14 14 14 14 14 12 12 
12 12 0 0 0 0 0 0 0 0 0 0 0 0 0 0 0 0 0 0 0 10 9 9 9 9 9 9 9 9 9 9 9 9 10 14 14 14 14 14 14 14 14 14 14 14 14 14 12 12 
12 12 0 0 0 0 0 0 0 0 0 0 0 0 0 0 0 0 0 0 0 10 9 9 9 9 9 9 9 9 9 9 9 9 10 14 14 14 14 14 14 14 14 14 14 14 14 14 12 12 
12 12 0 0 0 0 0 0 0 0 0 0 0 0 0 0 0 0 0 0 0 10 9 9 9 9 9 9 9 9 9 9 9 9 10 14 14 14 14 14 14 14 14 14 14 14 14 14 12 12 
12 12 0 0 0 0 0 0 0 0 0 0 0 0 0 0 0 0 0 0 0 10 9 9 9 9 9 9 9 9 9 9 9 9 10 14 14 14 14 14 14 14 14 14 14 14 14 14 12 12 
12 12 0 0 0 0 0 0 0 0 0 0 0 0 0 0 0 0 0 0 0 10 9 9 9 9 9 9 9 9 9 9 9 9 10 14 14 14 14 14 14 14 14 14 14 14 14 14 12 12 
12 12 0 0 0 0 0 0 0 0 0 0 0 0 0 0 0 0 0 0 0 10 9 9 9 9 9 9 9 9 9 9 9 9 10 14 14 14 14 14 14 14 14 14 14 14 14 14 12 12 
12 12 10 10 10 10 10 10 10 10 10 10 10 10 10 10 10 10 10 10 10 10 9 9 9 9 9 9 9 9 9 9 9 9 10 14 14 14 14 14 14 14 14 14 14 14 14 14 12 12 
12 12 1 1 1 1 1 1 1 1 1 1 1 1 1 1 1 1 1 1 1 10 9 9 9 9 9 9 9 9 9 9 9 9 10 14 14 14 14 14 14 14 14 14 14 14 14 14 12 12 
12 12 1 1 1 1 1 1 1 1 1 1 1 1 1 1 1 1 1 1 1 10 9 9 9 9 9 9 9 9 9 9 9 9 10 14 14 14 14 14 14 14 14 14 14 14 14 14 12 12 
12 12 1 1 1 1 1 1 1 1 1 1 1 1 1 1 1 1 1 1 1 10 10 10 10 10 10 10 10 10 10 10 10 10 10 10 10 10 10 10 10 10 10 10 10 10 10 10 12 12 
12 12 1 1 1 1 1 1 1 1 1 1 1 1 1 1 1 1 1 1 1 10 15 15 15 15 15 15 15 15 15 15 15 15 15 15 15 15 15 15 15 15 15 15 15 15 15 15 12 12 
12 12 1 1 1 1 1 1 1 1 1 1 1 1 1 1 1 1 1 1 1 10 15 15 15 15 15 15 15 15 15 15 15 15 15 15 15 15 15 15 15 15 15 15 15 15 15 15 12 12 
12 12 1 1 1 1 1 1 1 1 1 1 1 1 1 1 1 1 1 1 1 10 15 15 15 15 15 15 15 15 15 15 15 15 15 15 15 15 15 15 15 15 15 15 15 15 15 15 12 12 
12 12 1 1 1 1 1 1 1 1 1 1 1 1 1 1 1 1 1 1 1 10 15 15 15 15 15 15 15 15 15 15 15 15 15 15 15 15 15 15 15 15 15 15 15 15 15 15 12 12 
12 12 1 1 1 1 1 1 1 1 1 1 1 1 1 1 1 1 1 1 1 10 15 15 15 15 15 15 15 15 15 15 15 15 15 15 15 15 15 15 15 15 15 15 15 15 15 15 12 12 
12 12 1 1 1 1 1 1 1 1 1 1 1 1 1 1 1 1 1 1 1 10 15 15 15 15 15 15 15 15 15 15 15 15 15 15 15 15 15 15 15 15 15 15 15 15 15 15 12 12 
12 12 1 1 1 1 1 1 1 1 1 1 1 1 1 1 1 1 1 1 1 10 15 15 15 15 15 15 15 15 15 15 15 15 15 15 15 15 15 15 15 15 15 15 15 15 15 15 12 12 
12 12 1 1 1 1 1 1 1 1 1 1 1 1 1 1 1 1 1 1 1 10 15 15 15 15 15 15 15 15 15 15 15 15 15 15 15 15 15 15 15 15 15 15 15 15 15 15 12 12 
12 12 1 1 1 1 1 1 1 1 1 1 1 1 1 1 1 1 1 1 1 10 15 15 15 15 15 15 15 15 15 15 15 15 15 15 15 15 15 15 15 15 15 15 15 15 15 15 12 12 
12 12 1 1 1 1 1 1 1 1 1 1 1 1 1 1 1 1 1 1 1 10 15 15 15 15 15 15 15 15 15 15 15 15 15 15 15 15 15 15 15 15 15 15 15 15 15 15 12 12 
12 12 1 1 1 1 1 1 1 1 1 1 1 1 1 1 1 1 1 1 1 10 15 15 15 15 15 15 15 15 15 15 15 15 15 15 15 15 15 15 15 15 15 15 15 15 15 15 12 12 
12 12 1 1 1 1 1 1 1 1 1 1 1 1 1 1 1 1 1 1 1 10 15 15 15 15 15 15 15 15 15 15 15 15 15 15 15 15 15 15 15 15 15 15 15 15 15 15 12 12 
12 12 1 1 1 1 1 1 1 1 1 1 1 1 1 1 1 1 1 1 1 10 15 15 15 15 15 15 15 15 15 15 15 15 15 15 15 15 15 15 15 15 15 15 15 15 15 15 12 12 
12 12 1 1 1 1 1 1 1 1 1 1 1 1 1 1 1 1 1 1 1 10 15 15 15 15 15 15 15 15 15 15 15 15 15 15 15 15 15 15 15 15 15 15 15 15 15 15 12 12 
12 12 1 1 1 1 1 1 1 1 1 1 1 1 1 1 1 1 1 1 1 10 10 10 10 10 10 10 10 10 10 10 10 10 10 10 10 10 10 10 10 10 10 10 10 10 10 10 12 12 
12 12 1 1 1 1 1 1 1 1 1 1 1 1 1 1 1 1 1 1 1 10 11 11 11 11 11 11 11 11 11 11 11 11 11 11 11 11 11 11 11 11 11 11 11 11 11 11 12 12 
12 12 1 1 1 1 1 1 1 1 1 1 1 1 1 1 1 1 1 1 1 10 11 11 11 11 11 11 11 11 11 11 11 11 11 11 11 11 11 11 11 11 11 11 11 11 11 11 12 12 
12 12 1 1 1 1 1 1 1 1 1 1 1 1 1 1 1 1 1 1 1 10 11 11 11 11 11 11 11 11 11 11 11 11 11 11 11 11 11 11 11 11 11 11 11 11 11 11 12 12 
12 12 1 1 1 1 1 1 1 1 1 1 1 1 1 1 1 1 1 1 1 10 11 11 11 11 11 11 11 11 11 11 11 11 11 11 11 11 11 11 11 11 11 11 11 11 11 11 12 12 
12 12 10 10 10 10 10 10 10 10 10 10 10 10 10 10 10 10 10 10 10 10 11 11 11 11 11 11 11 11 11 11 11 11 11 11 11 11 11 11 11 11 11 11 11 11 11 11 12 12 
12 12 4 4 4 4 4 4 4 4 4 10 7 7 7 7 7 7 7 7 7 10 11 11 11 11 11 11 11 11 11 11 11 11 11 11 11 11 11 11 11 11 11 11 11 11 11 11 12 12 
12 12 4 4 4 4 4 4 4 4 4 10 7 7 7 7 7 7 7 7 7 10 11 11 11 11 11 11 11 11 11 11 11 11 11 11 11 11 11 11 11 11 11 11 11 11 11 11 12 12 
12 12 4 4 4 4 4 4 4 4 4 10 7 7 7 7 7 7 7 7 7 10 11 11 11 11 11 11 11 11 11 11 11 11 11 11 11 11 11 11 11 11 11 11 11 11 11 11 12 12 
12 12 4 4 4 4 4 4 4 4 4 10 7 7 7 7 7 7 7 7 7 10 11 11 11 11 11 11 11 11 11 11 11 11 11 11 11 11 11 11 11 11 11 11 11 11 11 11 12 12 
12 12 4 4 4 4 4 4 4 4 4 10 7 7 7 7 7 7 7 7 7 10 11 11 11 11 11 11 11 11 11 11 11 11 11 11 11 11 11 11 11 11 11 11 11 11 11 11 12 12 
12 12 4 4 4 4 4 4 4 4 4 10 7 7 7 7 7 7 7 7 7 10 11 11 11 11 11 11 11 11 11 11 11 11 11 11 11 11 11 11 11 11 11 11 11 11 11 11 12 12 
12 12 4 4 4 4 4 4 4 4 4 10 7 7 7 7 7 7 7 7 7 10 11 11 11 11 11 11 11 11 11 11 11 11 11 11 11 11 11 11 11 11 11 11 11 11 11 11 12 12 
12 12 4 4 4 4 4 4 4 4 4 10 7 7 7 7 7 7 7 7 7 10 11 11 11 11 11 11 11 11 11 11 11 11 11 11 11 11 11 11 11 11 11 11 11 11 11 11 12 12 
12 12 4 4 4 4 4 4 4 4 4 10 7 7 7 7 7 7 7 7 7 10 11 11 11 11 11 11 11 11 11 11 11 11 11 11 11 11 11 11 11 11 11 11 11 11 11 11 12 12 
12 12 4 4 4 4 4 4 4 4 4 10 7 7 7 7 7 7 7 7 7 10 11 11 11 11 11 11 11 11 11 11 11 11 11 11 11 11 11 11 11 11 11 11 11 11 11 11 12 12 
12 12 4 4 4 4 4 4 4 4 4 10 7 7 7 7 7 7 7 7 7 10 11 11 11 11 11 11 11 11 11 11 11 11 11 11 11 11 11 11 11 11 11 11 11 11 11 11 12 12 
12 12 4 4 4 4 4 4 4 4 4 10 7 7 7 7 7 7 7 7 7 10 11 11 11 11 11 11 11 11 11 11 11 11 11 11 11 11 11 11 11 11 11 11 11 11 11 11 12 12 
12 12 12 12 12 12 12 12 12 12 12 12 12 12 12 12 12 12 12 12 12 12 12 12 12 12 12 12 12 12 12 12 12 12 12 12 12 12 12 12 12 12 12 12 12 12 12 12 12 12 
12 12 12 12 12 12 12 12 12 12 12 12 12 12 12 12 12 12 12 12 12 12 12 12 12 12 12 12 12 12 12 12 12 12 12 12 12 12 12 12 12 12 12 12 12 12 12 12 12 12 
